.
GGGGGGGGGGGGGGGGGGGGGGGGGGGG
TBTBTBTBTBTBTBTBTBTBTBTBTBTB
BTBTBTBTBTBTBTBTBTBTBTBTBTBT
TBTBTBTBTBTBTBTBTBTBTBTBTBTB
BTBGGGGGGGGGGGGGGGGGGGGGGTBT
TBTGGGGGGGGGGGGGGGGGGGGGGBTB
BTBGGGGGGGGGGGGGGGGGGGGGGTBT
TBTGGGGGGGGGGGGGGGGGGGGGGBTB
BTBGGGGGGGGGGGGGGGGGGGGGGTBT
TBTGGGGGGGGGGGGGGGGGGGGGGBTB
BTBGGGGGGGGGGGGGGGGGGGGGGTBT
TBTGGGGGGGGGGGGGGGGGGGGGGBTB
BTBGGGGGGGGGGGGGGGGGGGGGGTBT
